################################
#                              ##
#                              ##
#                              ##
#""""                          ##
#     """""  """  ""           ##
#                    """"      ##
#            """""             ##
#      """"     """"""         ##
#""""               """""      ##
#      """""""                 ##
#                """""         ##
#                              ##
#   ""  "" """""               ##
#  "                           ##
#""""""""""""""""""""""""""""""##
#################################
