################################
#                              #
#                              #
#                              #
#                              #
#                              #
#                              #
#                              #
#                              #
#""""                          #
#####                          #
#     """""  """  ""           #
#                              #
#                    """"      #
#            """""             #
#                              #
#      """"     """"""         #
#                              #
#""""               """""      #
#                              #
#      """""""                 #
#                              #
#                """""         #
#                              #
#   ""  "" """""               #
#                              #
#"""                           #
####"""""""""""""""""""""""""""#
################################
