################################
#                              ##
#                              ##
#                              ##
#                              ##
#                              ##
#                              ##
#                              ##
#                              ##
#                              ##
#                              ##
#                              ##
#                              ##
#                              ##
#                              ##
#                              ##
#""""""""""""""""""""""""""""""##
#################################
