################################
#                              ##
#                              ##
#                              ##
#                              ##
#                              ##
#                              ##
#                              ##
#                              ##
#                              ##
#                              ##
#                              ##
#                              ##
#                              ##
#   ""                         ##
#  "                           ##
#""""""""""""""""""""""""""""""##
#################################
